bioacoustics: Analyse Audio Recordings and Automatically Extract Animal Vocalizations
Contains all the necessary tools to process audio recordings of various formats (e.g., WAV, WAC, MP3, ZC), filter noisy files, display audio signals, detect and extract automatically acoustic features for further analysis such as classification.

Version:	0.2.8
Depends:	R (≥ 3.3.0)
Imports:	htmltools, graphics, grDevices, methods, moments, Rcpp (≥ 0.12.13), stringr, tools, tuneR (≥ 1.3.0)
LinkingTo:	Rcpp
Suggests:	knitr, markdown, rmarkdown
Published:	2022-02-08
Author:	Jean Marchal [aut, cre], Francois Fabianek [aut], Christopher Scott [aut], Chris Corben [ctb, cph] (Read ZC files, original C code), David Riggs [ctb, cph] (Read GUANO metadata, original R code), Peter Wilson [ctb, cph] (Read ZC files, original R code), Wildlife Acoustics, inc. [ctb, cph] (Read WAC files, original C code), Jordan Biserkov [ctb], WavX, inc. [cph]
Maintainer:	Jean Marchal <jean.marchal at wavx.ca>
BugReports:	https://github.com/wavx/bioacoustics/issues/
License:	GPL-3
URL:	https://github.com/wavx/bioacoustics/
NeedsCompilation:	yes
SystemRequirements:	C++11, fftw3, GNU make
Materials:	README NEWS
CRAN checks:	bioacoustics results
Documentation:
Reference manual:	bioacoustics.pdf
Vignettes:	Introduction to bioacoustics
Tutorial: Detection, Extraction and Classification of Bird and Bat Vocalizations in R
Downloads:
Package source:	bioacoustics_0.2.8.tar.gz
Windows binaries:	r-devel: bioacoustics_0.2.8.zip, r-release: bioacoustics_0.2.8.zip, r-oldrel: bioacoustics_0.2.8.zip
macOS binaries:	r-release (arm64): bioacoustics_0.2.8.tgz, r-oldrel (arm64): bioacoustics_0.2.8.tgz, r-release (x86_64): bioacoustics_0.2.8.tgz, r-oldrel (x86_64): bioacoustics_0.2.8.tgz
Old sources:	bioacoustics archive
Reverse dependencies:
Reverse imports:	warbleR
Linking:
Please use the canonical form https://CRAN.R-project.org/package=bioacoustics to link to this page.	